abated: sensibly
abhorrence: lordly
abjuration: immediate
abnegation: deliberate
abstract: compendious
abstraction: shadowy, unagitated
absurdity: economic, inconceivable, laughable, monstrous
abundance: generous, inexhaustible
abuse: boorish, unsparing
abyss: bottomless
acceleration: slight
accents: clattering, excruciating
acceptable: exceedingly
acceptance: alert
accident: subversive
acclaim: widespread
acclamation: general, simultaneous, unanimous
accommodating: affably
accusation: taunting
achievement: inspiring, knightly, master, renowned, worthy
acknowledgment: belated
acquaintance: cursory
acquiescence: formal, lazy, timid, unforced
acquisition: valuable
act: overt
action: concerted, drastic, reprehensible
activity: asserted, bodily, enfeebled, multifarious, redoubled, ubiquitous, unimpeded, wonted
acumen: business
acuteness: philosophical
adaptation: artful, intelligent
adherence: lifelong, persistent
adherent: distant
adherents: enthusiastic
adhesion: loyal
adjuncts: necessary
admiration: boundless, calculating, challenge, fanatical, frank, honest, unreproved
admission: damaging
adoration: rapturous
adorned: decorously
advance: unprecedented
advances: coquettish
advantage: concealed, subsidiary, vast
advantages: costly
adventure: digressional, profitable
adventurer: dreaming, unscrupulous
advice: palatable
affability: engaging
affectation: crude
affectations: euphuistic
affection: unchanging
affirmation: omniscient
affluence: wonderful
affront: mortal
age: impoverished, problematic
agent: accredited
agility: apish, gymnastic
agitation: cowering, hysterical, violent
agony: convulsive, protracted, silent
agreement: substantial
aids: auxiliary
air: conciliating, disengaged, distraught, forbidding, imponderable, unapologetic
airs: bewitching
alacrity: joyful
all-influence: pervading
allegiance: nominal, unwavering, willing
alliance: defensive, fanciful, matrimonial, unwelcome, unworthy
allied: intimately
alliteration: jingling
allowance: charitable, niggardly
allurement: soft
allurements: capricious, meretricious
allusion: jesting
allusions: commonplace, piquant
aloofness: complete
amazement: dumbfounded
ambition: abjured, devouring, inordinate, leaping, meek, soaring, uncharitable, youthful
amenities: innocent
amity: heartfelt
amplification: rhetorical
amplitude: mouthing, similar
amused: indecorously
amusement: salutary, undisguised
ancestors: protoplasmic
anchorage: secure
anecdote: illustrative
anger: unrestrained
animosities: rancorous
animosity: eager, jealous, mighty, mutual, voracious
answer: evasive
antagonist: jubilant, wily
anticipated: confidently
anticipations: glowing, sublime, undefined
antipathy: inveterate
antiquity: hoary
antithesis: exact
anxieties: inherited
anxiety: harassing, trembling
apathy: listless
apologetic: abysmally, objectionably
apology: drab, stammered, unseasonable
apparel: bizarre
apparition: frightful
apparitions: ghostly
appeal: agonizing, barefaced, insufficient, turgid, vociferous
appearance: anomalous, cadaverous, dismantled, exotic, motley, prepossessing
appellation: endearing
appellations: unknown
appraisement: accurate
appreciation: boyish, inadequate
apprehended: incompletely
approach: roundabout
approbation: deserved, negative
approval: affectionate, conditional, cordial, nodding, witnessing
aptitude: small
ardor: confessed, dampened, frantic, repressed
argument: irrefutable, overpowering, plenary, sophistical, unanswerable, weighty
arguments: assembled, mangled
aristocracy: effete
arranged: commodiously
arrangement: amicable, infelicitous
arrogance: hereditary
artifice: amazing, specious
artistry: finished
artlessness: amusing, seeming
ascendency: conspicuous, undisputed
ascetic: sourly
aspect: disreputable, flattering
aspects: component, indivisible, lowering
asperity: official
aspersions: malicious
aspiration: huge
aspirations: loftiest, wholesome
assent: unfeigned, unreserved
assertion: blustering, fatiguing, preposterous, stout, sweeping, temerarious, valueless
assimilation: organic
assistant: ambidextrous
associated: inseparably
association: indistinct, straggling
associations: legendary
assumption: erroneous, mistaken, preliminary, tacit, underlying
assumptions: baseless
assurance: dogmatic
assurances: loquacious
astonishment: unmixed
asunder: torn
atoms: indestructible
atrocities: unparalleled
attachment: devoted
attack: flagitious
attacks: envenomed
attainments: linguistic, scholarly
attempt: juvenile, purposed
attention: anticipated, enraptured, focused, preoccupied, riveted, tense, undistracted
attitude: affirmative, commanding, disappointing, iconoclastic, menacing, subaltern
attractive: uncommonly
attributes: diversified
audacities: verbal
audacity: blazing, characteristic, dissolute, forceful, irreverent, unusual
augury: favorable
austerity: despairing, dignified, inscrutable, monastic, priestly, rugged
authenticity: doubtful, undoubted
authority: acknowledged, competent, evident, imperial, inexorable, paramount, recognized, unresisted
autocracy: military
avarice: wounded
aversion: dull, pet, strong, unconcealed
awakening: rude
awe: irrational
axioms: narrowing
azure: ethereal
babble: distracting, futile
babbler: prolegomenous
babel: insistent
badinage: condescending
banalities: social
barbarism: insensate
barrier: formidable
barriers: countless
barrister: briefless
bearing: courtly, sociological, twofold
beauties: unheeded
befogged: hopelessly
begrimed: noticeably
behavior: culpable, submissive, unbecoming
belaud: unctuously
belief: fatalistic
benefactor: anonymous
benevolence: expansive
benignity: inexpressible
beset: sorely
bewilderment: feverish, stupid
billows: raging
biography: voluminous
bitterness: unimaginable
blackness: floating, inky
blandishment: ineffectual
blandishments: gentle
blandness: inapposite
blare: resounding
blending: uniform
blot: insignificant
blows: retaliating
blue: cerulean
blunder: irretrievable
blush: prismatic
blustering: scurrilous
boasting: flagrant
body: aggregate
boldness: triumphant
bombast: stilted
boredom: obvious, sheer
braggadocio: tiresome
braggart: intriguing
brain: dazed
breeze: freshening, smacking, tempestuous, whispering
brevity: algebraic
brightness: intrusive, resplendent
brilliancy: flamboyant
brooks: gurgling
brotherhood: declared
brow: symmetrical
brutality: purblind, rough
bulk: unwieldy
bully: swaggering
bulwark: immemorial
burden: accumulated
business: burdensome, pettifogging
busybody: local
butchery: wanton
byways: secluded
cadence: measured, plaintive, swinging
calamity: averted, untold
calculations: divergent
callousness: stoic
calmness: impenetrable
calumny: foul
candor: artless, daring, judicious
capacities: dormant
capacity: balanced
caprice: extravagant
capriciousness: feminine
care: punctilious
career: beneficent, chequered, pestiferous, variegated
cares: inconsolable, onerous
caste: privileged
casuists: eccentric
cause: nugatory
censor: merciless
censure: indiscriminate, severe
centuries: vanished
cessations: instantaneous
challenge: spontaneous
changes: cosmical
chant: choral
chaos: howling
character: abstract, colonial, compensatory, unblemished, unpretentious
characteristics: generic, normal, specific
charm: austere, delusive, elusive, enduring, enthralling, exhilarating, heightened, matchless, perennial, undeniable, vernal
chasm: gaping, unbridgeable
cheek: damask
cheeks: furrowed
cheerfulness: external, modest
chorus: rousing
chronicler: indisputable
circumlocution: flowery
circumstance: eventful, extenuating, fortuitous, notable, straitened
circumstances: accessory, attending, mitigating, untoward, vexatious
civility: diffident
clamor: gusty, increasing, riotous
clearness: piercing, poignant
cleverness: superlative
clouds: fleecy, overvaulting
coincidence: curious, pure
coldness: defiant, mortified
command: superb
commendable: wholly
comment: disdainful
commercialism: ruthless
commodity: marketable
commonness: stereotyped
commonplace: smirking
commonplaces: barest, plausible
compact: indissoluble
companion: boon
comparison: conceivable
complacency: immense, temperamental
complement: transparent
complexities: theological
compliance: dutiful, obedient
complications: annoying
compliment: equivocal, impersonal
composition: elaborate, invaluable, raw
composure: brutal, demure, equable, haughty, leisurely, recovered
comprehension: dim
comprehensive: tolerably
concealment: implied
conceit: injured, stiff
conception: definite
concession: cowardly
concessions: magnanimous
conclusion: demonstrable, foregone, rueful
conclusions: crystallized, formulated
concomitants: depressing
concord: unruffled
condensation: close
condescension: noble, respectful
condition: exultant, inopportune
conditions: environing, mollifying, prescribed, primordial
condolence: blessed
condoned: glibly
conduct: exemplary, inconsistent, knavish
confidence: bland, cool, inviolable, jaunty, unexpected, unflecked
conformations: shapeless
confusion: aimless, inextricable, jostling, meaningless, whirling
conjecture: disconcerted, improbable, unfounded
connection: immaterial
consanguinity: traceable
conscience: flickering
conscious: acutely
consciousness: blissful, civic, consoling, unfolding
consent: unmingled
consideration: minute
considered: zoologically
consistency: undeviating
consolation: unavailing
conspirator: arch
constancy: incorruptible
constellations: irregular
constituent: corporeal
constitution: flawless
construction: defective, indulgent
consummation: dire
contemplation: vain
contemplations: liberal
contempt: bigoted, disguised, hearty, immitigable, private, skeptical
contingency: impossible, unlikely
continuity: unbroken
contortions: lithe
contrast: incongruous
contrived: cunningly, opportunely
controversy: acrid, imbittered
conventionality: trivial
conviction: latent, profound, subconscious, tepid
convulsion: physical
convulsions: stifled
coolness: dewy, exasperating
copiousness: inoffensive
coquetry: ineradicable
coquette: superannuated
corollary: inevitable
correct: approximately
corroboration: empirical
counsels: poisonous
countenance: beaming, glowering, mobile, regal, woebegone
courage: dauntless, hesitating, obdurate, prompt, wavering
course: calamitous
courteous: sensitively
courtesy: ceremonious, hospitable, princely, unfailing
coxcomb: lettered
craft: frail, unprofitable
crash: stunning
craving: uneasy
creation: immortal
creature: bloodless
credulity: grasping
creed: ancestral, outworn
cries: penitential
critic: authoritative, carping, censorious, discerning, incisive, satirical, uninstructed
criticism: disarmed, disparaging, facile, interpretative, prying, scorching
cudgeling: bucolic
culprit: crouching, quailing
cultivated: assiduously
cultivation: intensive
culture: ample
cup: translucent
curiosity: awakened, covert, inflamed, scientific
current: weltering
curves: serpentine
cymbal: tinkling
cynicism: chilled, genuine, quiet, revolting
damage: connotative
dampness: fetid
dangerous: absurdly
daring: resolute
darkness: overhanging
darling: pampered
data: available, questionable
dawn: reddening, unmellowed
daybeams: effulgent
days: shortening
dazzlement: spiritual
dead: irreclaimable
death: clammy
decay: deplorable
deception: crafty
decorated: sumptuously
decorations: garish, mural
decorousness: mingled
decorum: conversational
decree: omnipotent
deep-curiosity: seated
deep-lamentations: toned
defeats: numberless
defender: undaunted
deference: attentive, habitual, infinite, unobtrusive
defiance: desperate, gay, impious, obstinate, pugnacious, scoffing, stalwart, stern
degradation: lowest
dejection: awful
delight: indwelling, uncontrollable, unspeakable
delights: fireside
delinquencies: ordinary
demagogues: infuriated
demarcations: class
demeanor: bored, graceful, shamed, unconventional
denial: derogatory, flat
denizens: illiterate
denunciation: indignant, profane
deportment: slovenly
depreciation: unjust
depression: misty, needless
depth: ocean, tideless
depths: uncharted
derelict: human
derision: public
described: baldly
description: recondite
desecrater: vile
desert: deserted
desertion: pusillanimous
desideratum: distinct
design: comprehensive
designated: inaptly
designation: appropriate
desire: aching, fitful, prurient
desires: bacchanalian
desolation: blanched, forlorn
despair: haunting, quenchless
desperation: impotent
despotism: grinding
destiny: proud
desuetude: innocuous
details: harrowing, multitudinous, picturesque, unessential
deteriorating: positively
determination: craven, dogged, pending, unalterable, unshrinking
detonations: muffled
development: arrested
deviation: imperceptible
devotion: ascetic, awed, zealous
dewdrop: glistening
dexterity: intrepid, manual
dialogue: crisp
diapason: musical
diction: magniloquent
diet: abstemious
difference: hairbreadth, perceptible
difficulties: appalling
difficulty: insuperable
diffidence: becoming
dignity: apostrophic, inaccessible, inherent, majestic, pinchbeck, pretentious, pristine, unassuming, unimpassioned
digression: frequent
dilemma: awkward
diligence: indefatigable, unwearied
dimensions: puny
diplomacy: petticoat
directness: cutting
directorate: interlocking
disapproval: instinctive
discernment: excellent
discipline: invigorating, productive, relaxed
disclosure: fatal
discomfiture: humiliating, momentary
disconcerted: sadly
discontent: fretful, supercilious
discord: jarring
discourse: blatant, inaugural, rational
discourtesy: blundering
discrimination: delicate, nice
discursive: vaguely
discussion: heated
disdain: freezing, frigid, ineffable, virtuous
disguise: disfiguring
disinclination: inward
disingenuousness: known
dislike: settled
dismay: secret
disparity: functional
dispelled: successfully
display: colloquial, fantastic, oratorical, ostentatious, unostentatious
disposition: pacific, querulous, reputed, tyrannical, unresentful, yielding
disputant: controversial, wriggling
disregard: blithe, cynical, lightly
disrelish: dreary
disrespect: contemptuous
dissembler: unlucky
disseminated: openly
dissension: internal
dissent: immature
dissertation: endless
dissertations: wise
dissimilar: altogether
dissonance: shrill
distinction: desirable, radical, rightful, unrivaled
distortion: different
distractions: scattered
distress: squalid
distrust: conservative, unreasoning
diversions: bibulous
diversity: striking
doctrine: esoteric, evangelic, pernicious
doctrines: moldy
document: testamentary
doggedness: irascible
dogmatism: uncompromising
domain: entire
domination: ignoble, tremendous
dose: nauseous
doubt: recurring, uncomfortable
drama: purposeful
dread: apprehensive, desolating, overshadowing
dreamer: unphilosophical, visionary
dribble: feeble
drollery: impertinent
drone: nasal
drudge: downtrodden, overworked
ductility: elastic
dull: insufferably
duration: ephemeral
dusk: deepening
duties: collateral
duty: incidental
eagerness: breathless, courageous, panting, ravenous
ear: thirsting
earnestness: emphatic, perusing
ease: accomplished, flippant, polished, unrestricted, vacuous
eccentricity: startling
echoes: unmelodious
ecstasies: delirious, heavenly
eddyings: circling
edification: boisterous
edifice: historic
education: efficient
effect: corrosive, devastating, narcotic
effects: acoustical
effeminacy: wretched
efficacious: equally
efficacy: diminished
efficiency: executive
effluvium: electric
effort: rudimentary
effusion: extemporaneous, mischievous
effusions: amatory
egotism: tireless
elegance: artistic
element: integral
elements: cataclysmic
eloquence: animated, coaxing, figurative, honeyed, liquid, mellifluous, persuasive, thrilling, unballasted
emanations: soporific
embarrassment: flushed, visible
embellishment: effective
embellishments: gaudy, pictorial
emblazoned: richly
embodiment: brilliant, perfect
embrace: encircling
embrasure: arched, curtained
eminence: craggy, starlit
emotion: commingled, palpitating, transient
emotions: elemental, hybrid
emphasis: magisterial, unrelaxing
emptiness: oppressive, solemn
enactment: coercive, legislative
enchantment: sleepy
encouragement: outspoken
endearment: domestic
endeavor: consecrated, continuous, fumbling
endowment: rare, stinted
endurance: patient, uncomplaining
enemy: accursed, cantankerous
energies: cramped, undivided, unwasting
energy: brisk, dynamic, exhaustless, potential, primal, superabundant, tameless, untameable, untiring
engrossed: busily, totally
enigma: geological
enjoyment: elevated
enormity: heinous
enshrined: assuredly
enterprise: competitive, educational, embryo, hazardous, wabbling
enthronement: final
enthusiasm: energetic, fervid, gushing, kindled, overstrained, patriotic, reverent, sham, spurious
enthusiasms: fussy
enthusiast: fond
entreaty: anguished, wistful
epigram: glittering, pungent
epithet: abusive, contumelious, opprobrious
epoch: important, remote
equanimity: disturbed
equipment: imperfect
equipoise: satisfying
equivalent: bloated
equivocations: lying
era: illustrious, reconstructive
error: unpardonable
escapades: silly
escutcheon: gleaming
espoused: earnestly
essence: ambrosial
estimate: conjectural, exaggerated
eulogy: rhapsodical
evasion: deft
events: concomitant
evidence: admissible, documentary, meager
exactions: unending
exactitude: photographic
exactness: literal, metrical
exaggeration: despondent, gross
exaltation: supreme
example: analogous, patent
excellence: average, incomparable, prosaic, typical
exception: sporadic
exceptions: unresolved
excitement: irrepressible, pleasurable, quivering, suppressed, vivacious
excrescence: unpleasant
execution: adequate
exegesis: scriptural
exercise: gladiatorial
exhortation: edifying
exigencies: changing
exile: impecunious
existence: inanimate
exordium: attractive
expectation: tingling
expectations: sanguine
expedient: farcical, frivolous, perilous, plainly, temporary, witty
expenditure: profligate
experience: adverse, enriched, garnered, memorable
expertness: requisite
explanation: apologetic
exposition: didactic
expressed: obligingly
expression: atrocious, contorted, felicitous, inadmissible, masked, quizzical, tuneful, undismayed, unhampered, untrammeled, vernacular
expressions: doggerel
exterior: ingratiating, irreproachable
extinction: speedy
extravagance: frolicsome, wild
exultations: royal
eye: naked, neutral, observant, searching
eyes: avaricious, lightless, undazzled
fabulous: unmistakably
facility: astonishing
factor: prime
facts: adduced, antecedent, disheartening, fragmentary, irreversible, verifiable
faculties: huddled, torpid
faculty: creative, nimble
failure: colossal, eventual
faith: flaccid, implicit, unhesitating
falsehood: scandalous
falsification: repeated
fame: broadening, contemporary
familiarities: chirpy
familiarity: chatty, friendly
fanaticism: besotted
fancies: disconnected, pursuing, winged
fancy: excursive, fertile, fickle, incipient, jovial, longing, unbridled, wandering, wayward
fantasy: nightmare
far-influence: reaching
farce: unmeaning
fascination: culminating, griping, hypnotic, magic, magnetic, weird
fashion: outlandish
fate: avenging, impending, unquestioning
faults: aggravated, glossed
favor: curry
fear: dispelling, groundless, nameless, panic
fears: belittling, spectral, uncanny
feature: informing, outstanding, salient
features: angular, debilitating
fecundity: intrinsic
feeling: distempered, unvarnished
feelings: engendered, lacerated, ruffled
felicity: conjugal, impeccable, inimitable
ferocity: bestial, cultivated
fertility: populous
fervor: appreciative, idolatrous
fetish: sacrosanct
fickleness: puerile
fidelity: scrupulous, unerring, unselfish
figure: bulky, recumbent, ungainly
filaments: silken
fires: purgatorial
fitness: compact
flame: fizzing, resentful
flatness: swampy
flattered: insensibly
flatterer: adroit
flatteries: fawning
flight: erratic, precipitous, unhindered
flights: occasional
flimsiness: beggarly
florescence: magnificent
foe: ferocious, quondam, vulnerable
foolishness: unworldly
footing: convenient
footsteps: elephantine, lagging, martial, retreating
forbearance: innate
force: augmented, compelling, demoniacal, expeditionary, laconic, obligatory, titanic
forcefulness: convincing
forebodings: doleful, sinister
forecast: correct
foreland: scrubby
forest: depthless, rustling, trackless
forfeit: unredeemable
form: fragile
formalities: cold
formality: curt, tedious
formula: arid
fortitude: heroic
fortress: impregnable
fortune: iniquitous
fostered: sedulously
foundation: unshakable
fragments: cumbrous
fragrance: aromatic, balmy, volatile
frailties: chronic
frankness: agreeable
freedom: bachelor, glorious, lawless, unconditioned
frenzy: foolish, hot, pitiable
friendliness: consistent
friendship: noteworthy, undying
frightened: causelessly
fripperies: useless
frivolities: bubbling
function: appointed
functions: manifold
gaiety: lumbering, resonant, shimmering, sportive
gait: lounging, shambling
gallantry: dashing
gallop: tearing
gambols: uncouth
garb: ancient, nondescript, unfamiliar
garbling: intentional
garden: enchanted
garrulity: easy, professional
gaze: embittered, questioning
generalities: vapid
generalization: bold, hasty, mere
generations: uncounted
generosity: kingly, profuse
genius: aspiring, presiding, undisciplined, unquestionable
gentility: malodorous
genuineness: sturdy
gesture: admonitory, beseeching
gestures: mimic
ghosts: grinning
gibberish: senseless
gift: incommunicable
girlhood: winsome
gladness: unearthly
glance: accusing, complimentary, furtive, mirthful, sidelong, unfaltering
glances: baleful, evanescent
glare: lightning
gloom: cavernous, funereal, gathering, intermingled, unmitigated, unresponsive
glories: departed
glory: posthumous
glow: gladsome
good-gibes: humored
goodness: unspoiled
gossip: babbling, current, irresponsible
governed: equitably
grace: borrowed, effeminate, elfish, harmonious, versatile, virgin
gradations: infinitesimal
grandeur: architectural, solitary, tranquil
grasp: caressing, greedy
gratification: tasteful
gratitude: impulsive
graveyard: forgotten
gravity: imperturbable, learned
grayness: olive
greeting: apathetic
grief: immoderate
grimace: ambiguous
ground: vantage
growth: composite, indigenous
gulf: portentous
habit: predominant
habits: convivial, reflective, rooted
hallucinations: diseased
hand: nerveless
handicap: cruel, heavy
handicraft: mechanical
happiness: abounding, blighted, prolonged, radiant
happy: ecstatically
harvest: plentiful
haste: frenzied
hate: incarnate, seething
hatred: sterile
head: tousled
height: giant
helpfulness: practical
helplessness: lamentable, pathetic
heresy: besetting
high-theories: flying
hilarity: infectious
hills: undulating
hint: considerate, pregnant
hoarseness: rumbling
homage: discriminating, obsequious, unwilling
honor: befitting, inestimable, spotless
honors: coveted
hope: abandoned, chastened, verdant
hopes: fallacious
horde: oncoming
hordes: heathen
horizon: beckoning
hospitality: sincere, unbounded
host: jocund, welcoming
hostility: eternal, offensive, provoked, unmeasured
hosts: marshaled
hum: intoxicating
humanity: bellicose, gregarious, gullible
humiliation: assumed
humility: enervating
humor: freakish, impish, racy, rarefied
hypocrisies: detected, paltry
hypocrisy: blasphemous, sheltering, smug
hypocrite: canting, sanctimonious
hypothesis: unthinkable
iciness: ironic
idea: compound, germinal, glimmering
ideal: altruistic
idealists: constructive
ideals: actualized, desecrated
ideas: disproportionate, extraneous, fluid, reanimating
idiosyncrasies: little
idleness: alluring, cultured
ill-impatience: concealed
illuminations: festive
illumined: pallidly
illusion: dissipated
illusions: false
illusiveness: fascinating
illustration: apposite
imagery: flowing, rural
images: thronging
imagination: agitated, disordered, exalted, morbid, splenetic
imaginative: weakly
imbecility: lifeless
imitated: professedly
imitation: shabby, slavish
imitations: miniature
immobility: metallic, statuesque
immunity: gracious
impartiality: judicial
impatience: fidgety, irritable
impertinence: languid, snappish
impetuosity: indelicate
impetus: fresh
importance: mundane, overestimated
importunity: brazen
imposed: arbitrarily
imposition: arrogant
imprecations: fearful, terrifying
impression: baneful, blended, durable, stimulating
impropriety: glaring
impudence: dexterous
impulse: governing, humanitarian, impassioned, propelling, quixotic, thwarted
impulses: minor, shaping
inactivity: cursed
incessantly: inveighing
incident: supernatural
incoherence: guttural
incompatibility: wedded
incompetence: native
incongruity: droll, ineffaceable, ludicrous
inconsistencies: humdrum
inconsistency: villainous
incredulity: sarcastic
indebtedness: imprudent
independence: godlike
indications: authentic
indifference: affected, callous, hardened, polite, tolerant, unfathomable
indignation: fiery, fluffy, fruitful, righteous
indiscretion: crowning
individuality: marked
indolence: blameless, contented
indulgence: hurtful
industry: clangorous
inefficiency: muddy
ineptitude: pedantic
inequalities: mountainous
inertness: troubled
infelicity: comic
inference: incontestable, legitimate
inferior: admittedly
influence: civilizing, contaminating, dominating, generative, gladdening, malign, reciprocal, refining, restorative, retarding, subduing, wizard
influences: conflicting
information: circuitous, garbled
informed: credibly
ingenuity: malevolent
ingenuousness: childlike
ingratitude: peevish, wicked
injunction: explicit
injury: irreparable
injustice: dastardly, shameless
innocence: defenseless, halcyon, helpless, kindly, tortured, unaffrighted
inquiries: perfunctory
inquisitiveness: restless
insensibility: merciful, mute
insensible: clownishly
insight: clear, illuminating, keen, sympathetic
insincerity: disclosed
insipidity: mawkish, tasteless, unenvied
insistence: passionate, strenuous
insolence: domineering, dynastic, flaunting, unabashed, veiled
instance: celebrated, crucial
instinct: dawning, selective
instincts: chary
institutions: democratic, monarchial
integrity: fearless, inflexible, intellectual, unswerving
intelligence: conquering, gifted, treacherous, unprejudiced
intensity: maximum, tragic
intention: avowed
interaction: systematic
intercourse: nascent
interests: diverting
interference: warranted
interlacings: intricate
interlude: bright
interpretation: luminous, strained, vital
interrogation: indirect
interruption: illogical
intimacy: surprising
intimation: fleeting, obscure
intimations: audible
intrigues: base
intuition: happy
invective: furious, vigorous
invectives: insulting
invocation: fervent
irony: crucifying, splendid
irrevocable: absolutely
iteration: unblushing
jangle: crunching
jargon: dissonant
jarrings: harsh
jealousy: inventive, sickening
jest: merry
jesting: idle
jests: scalding
jibes: sneering
jocularity: tipsy
jottings: formless
journals: veracious
joy: budding, celestial
joys: hollow
judgment: critical, dispassionate, infallible, synthetic, unbiased
jumpings: galvanic
justice: impartial, relentless
kindliness: unexhausted
kindness: invariable, unwonted
kingdom: mythical
knowingness: impudent
knowledge: solid, statistical
laborer: unlettered
labors: emancipating, erudite
labyrinth: tortuous
lady: affianced
lake: mirroring
language: affluent, ductile
lapse: accidental
laugh: bursting, fluttering
laughter: crackling, hushed, inexcusable, thawing, uproarious
lavished: prodigally
lavishness: reckless
law: abrogated, immutable
lawn: velvety
laws: dissimilar, irrefragable
laxity: distressing
leadership: virile
levity: labored
liberality: lavish
liberty: unfettered
life: nomadic, pulsating
light: fluctuating
lightness: frisky
lightning: livid
lights: myriad
limitation: resultant, unwarranted
limitations: imprisoning
lineage: aristocratic
lineaments: expressive
link: intermediate
lispings: inarticulate
literature: merchantable, propagandist
littleness: accepted
liveliness: dramatic
lodger: apocryphal
logic: remorseless, straightforward
loneliness: bleak, ghastly
longing: unfulfilled
look: sheepish, shrewish, skulking
loom: whirring
looseness: rambling
loquacity: incoherent
lost: irrecoverably
love: compassionate, connubial, heedless, ingrained, unrequited
loveliness: surpassing, womanlike
loyalty: attested
lucidity: accustomed, marvelous
lugubriou: indescribably
luster: humid, undimmed
lute: warbling
luxuriance: rank, tropical
luxury: demoralizing, unpurchasable
machinations: infernal
magnanimity: taciturn
magnificence: cloudy, faded, lone, mournful, parasitical
magnitude: exceptional, extended, stupendous, swelling
maintained: skillfully
majority: numerical
makeshifts: odd
malcontent: political
malice: bloodthirsty
malignity: hateful
manhood: staunch
mania: homicidal
manifestation: living
manner: decisive, dictatorial, lackadaisical, naive, nonchalant, patchwork, pontifical, verbose
marriages: maladjusted
mass: heterogeneous, opaque
mastery: consummate
materials: copious
maze: bewildering, complicated
meaning: mystic, restricted
means: surreptitious
measure: precautionary, remedial, unheroic
measures: gliding, sanguinary
mechanism: soulless
mediocrities: moribund
mediocrity: elegant
melancholy: manufactured, pining, quiescent, regretful, sober
memory: tenacious
mendicant: audacious, tattered
mention: invidious
merit: cardinal
meritorious: highly
merriment: incorrigible
metamorphosis: mental
metaphor: coined
method: inferential, zigzag
mien: imposing
might: resistless
mild: relatively
mind: adventurous, agile, capacious, dilettante, disciplined, imperious, plastic, sagacious, stultified, untutored
mingled: unwittingly
mingling: confused
minuteness: microscopic
mirth: exuberant, harmless, jocular, rollicking, unseemly
misanthrope: confirmed
mischief: incalculable
misconception: material, prevailing
misgiving: anxious, reproachful
misgivings: blank, rising
mist: hillside
mistake: egregious
mistaken: grievously
mistakes: astounding
mists: deceiving, neighboring
mode: feasible, identical
modesty: bashful, beautiful
moment: auspicious, propitious, tentative
monarch: throneless
monotone: grumbling
monotony: enlivened, lachrymose, maddening
monster: herculean
mood: facetious, melting, ruminating
moonshine: hortatory
motive: disinterested, ruling
movement: impelling, oscillatory, reactionary
movements: rhythmical, sinuous
multitude: effervescent, promiscuous, surging, voiceless
murmur: hissing
murmurs: broken
music: sensuous
musing: gloomy, melancholy
musings: miserable
myrmidons: culinary
mysteries: everlasting
narrative: prolix
nature: cloaked, contemplative, unyielding
neatness: obtrusive
necessity: coarse, imperative, pressing
necromancy: evil
needs: multiple
neglect: indolent
negligence: criminal, scornful
network: tangled
niceties: tactical
nomenclature: grandiose
non-way: committal
nonentity: eminent
nonsense: downright, idyllic
nook: sequestered
notable: particularly
nothingness: impalpable, willowy
notion: distasteful, foggy, misleading
notions: complex
novelty: refreshing
novice: unfledged
oath: sibilant
obedience: passive, servile, steadfast, vacillating
obeisance: shy
objection: conscientious, valid
objects: cherished
objurgation: classical
obligation: binding, direct, indelible
obliquity: moral
obscureness: parabolic
obscurity: dusky, metaphysical
observation: complaisant, unblinking
observer: astute, inquisitive, sane
obstacles: insurmountable
obstinacy: flighty, idiotic, impracticable, painful, stolid
occupation: ostensible, sedentary
oddities: misshapen
odious: doubly
odors: enticing
offense: unchastised
omen: bad
ominously: tightened
opinion: alternating, discretional, dissenting, gossiping, jaundiced, muddled
opinions: disconsolate, heretical, incendiary
opponent: discomfited, foremost, nettled, writhing
opportunities: barren
opportunity: abundant, fitting, golden
opposite: diametrically
oppression: loathsome
optimism: inflated, invincible, ranting
opulence: commercial, unlimited
orator: forensic
oratory: florid
organization: flimsy
originality: palpable
oscillation: perpetual
ostentation: haphazard
outbalanced: enormously
outburst: hilarious, paroxysmal, pyrotechnic
outcry: heartrending
outline: indented, jagged
outpouring: prolific
overrated: rashly
pages: autobiographical
panacea: sovereign
panorama: passing, shifting
panting: vehement
pardon: implored
parlance: genteel
parody: murderous
parrying: careless
parting: irreconcilable
partizan: blind, hostile
passion: diabolical, stormy, unmodified, venomous
path: precarious
pathos: homely, tempered, touching, unaffected
pathway: thorny
patience: unconquerable
pause: momentous
peace: brooding
peaceableness: sweet
peccadilloes: undignified
peculiarities: quaint
pedantries: concatenated, petty
pedantry: fatuous
pedestrian: ambling
peradventure: beyond
perception: intuitive
perfection: unattainable
perfidy: heartless
performance: creditable
period: bygone, initiatory
permission: parental
perpetuated: faithfully
perplexities: imminent, new
perplexity: intense
persistency: teasing
person: statesmanlike
personage: gentlemanly
personality: devitalized, disembodied, ennobling, unique
perspicacity: legal
perturbation: sudden
perverse: abominably
perversion: grotesque
pessimist: disgruntled
phantom: hideous
philosopher: disputative
phrase: cabalistic, succinct, trenchant, untuneful
phraseology: empty, obsolete
picture: appealing
pictures: kaleidoscopic
picturesque: extremely
picturesqueness: lurid
pilgrim: mendicant
pilgrimage: winding
pinnacles: emblazoned
piquancy: peculiar
pitfalls: hidden
pity: benignant, fraternal
placidity: insolent, venerable
plaintiveness: pretty, winning
plans: chaotic
platitudes: complacent, melodious, noisy, pious, pompous, unnecessary
play: homespun
playfulness: accentuated
pleasantries: stock
pleasure: especial, giddy, toilsome, unabated
pleasures: accessible
plenitude: full
plight: disgraceful
pluck: buoyant
plundering: unmerciful
poem: erotic
poets: decadent
point: debatable, pivotal
politeness: constrained
pomp: outward
pomposity: involved
popularity: flagging, waning
population: swarming, teeming
portraiture: detailed, difficult
portrayal: graphic, realistic, vivid
position: cosmopolitan, unassailable, uncritical
positiveness: boastful
possession: prized
possessions: treasured
possibility: unmastered
posture: suppliant
potency: mysterious, overmastering
potentialities: divine
power: assimilative, autocratic, counterbalancing, delegated, descriptive, dialectic, efficacious, emotive, hampered, masculine, necromantic, transcendent
powers: fathomless, improvising, leonine
praise: fulsome, halting, unstinted
prating: bombastic
prayer: ejaculatory
precaution: superfluous
precipice: crumbling, dizzy
precision: bookish, logical, mathematical, mincing, pitiless, technical
preconceptions: random
predecessor: unhappy
predilection: personal, undue
preeminence: sacerdotal
prejudice: partizan, provincial, racial, virulent
preliminaries: shuffling
prelude: inharmonious
prerequisite: essential
presence: dread, enveloping, hovering
prestige: impaired
pretense: braggart, hypocritical, infamous, unreasonable
pretensions: upstart
pretentiousness: tawdry
pretext: fictitious
pride: abated, indomitable, throbbing, towering
prig: pert
primness: puritanical
princes: dethroned
principles: basic, fundamental
privation: pecuniary
privilege: intrenched
probabilities: looming
probable: reasonably
problem: perplexing
process: uninterrupted
processes: psychic
prodigality: spendthrift, wasteful
productiveness: ascribed
profession: insincere, lucrative
profligacy: curbed
profligate: notoriously
profusion: miraculous
progress: accelerated, creeping
progression: geometrical, illimitable
project: ambitious
proletariat: starving
promiscuousness: seraphic
promise: indifferent
promulgated: originally
proof: clinching, incontrovertible
propagated: diligently, peacefully
propensities: unavoidable
propensity: factitious
prophecy: warning
propitiating: humbly
proportions: manageable
propriety: idiomatic, rigid
prose: voluble
prosperity: vulgar
protervity: unaccountable
protest: ardent, disgusted
protestations: angry
prowess: athletic
prudery: antiquated
pugnacit: wrathful
punctilio: proper
punishment: peremptory
purity: unsurpassed
purpose: circumscribed, commendable, detestable, engrossing, infirm, precise, ulterior, veering, warped
pursued: insinuatingly
pursuit: exclusive, subordinate
pursuits: archeological
quaintness: perverse
qualities: estimable
quality: adhesive, uncommunicable
quantity: negligible
quest: arduous
question: interminable, lugubrious, pertinent
questions: importunate
quiet: sepulchral
quizzical: lovingly
rack: inquisitional
raconteur: peerless
radiance: charming
radicalism: destructive
rage: thundering
ramifications: main
rant: hectoring
rapidity: alarming
rapture: simulated, tumultuous
rashness: compromising, condemnable
readiness: instant
realism: terse
realities: concrete, tangible
reality: everyday, stubborn, ungarnished
reason: shattered
reasoning: abstruse
reasons: contingent
reassurance: comforting
rebuke: administered, just, plainspoken, sharp
receptivity: large
recesses: inmost, murky
recognition: scant, tardy
recollection: hazy
recompensed: handsomely
recrimination: bitter
rectitude: simple
recurrence: regular
refinement: inborn, mellow
refinements: choicest
reflection: matured, prescient, ripe
reflections: chance, pensive, sage
refutation: eloquent, neat
regard: benevolent, deferential
regularity: methodical
reign: millennial
reiteration: constant
rejoinder: mild
relations: somber
relief: appreciable
relinquishment: voluntary
relish: undiminished
reluctance: alleged, coy, feigned, indefinable, inexplicable, manifest, shuddering
remark: caustic, inadvertent, trite
reminiscence: fragrant
reminiscences: discarded, disjoined, gabbling
remonstrance: irate
renown: imperishable
repentance: lukewarm
repetition: compulsory
repining: fruitless
repose: smiling, untroubled
reproach: stinging
reprobation: universal
repugnance: conscious
reputation: enhanced, tarnished
requisites: indispensable
research: independent, literary, ponderous
resented: unequivocally
resentment: cheap, fierce, implacable, popular, serious, smoldering, unappeasable
reservation: rigorous
reserve: admirable, constitutional, studious, unbending
resignation: calm, sorrowful, supine
resolution: iron, sluggish
resolved: ungenerously
resource: melodramatic, slender
response: answering, cheery
rest: dreamless
restlessness: inner
result: detrimental
reticence: grave, manly, painstaking
retirements: shady
retreat: ignominious, snug
retribution: consequent
revelation: climactic, ugly
reverence: listening
reverie: absorbed, noiseless
reveries: pleasing
revival: prosperity
reward: stipulated
rhymes: nonsense
riches: unguessed
richness: luxuriant
riddles: insoluble
ridicule: merited
right: inalienable
rigidity: adamantine
rigor: academic
ripening: premature
romance: abiding
rotation: diurnal
rubbish: speculative
rudeness: bearish, gratuitous, loutish, shocking
rule: ecclesiastical
rulers: despotic
rumors: ominous
rusticity: blunt
sacredness: familiar
sacrifice: atoning
sacrifices: expiatory
sadness: entrancing, unrepining, unutterable
sagacity: baffled, gigantic, preternatural, remarkable
sallies: epigrammatic
sameness: monotonous, unrefreshing
sanction: ultimate
sapient: waggishly
sarcasm: brittle
satire: blistering, scathing
satirist: savage
satisfaction: hungry, unalloyed
saturnalia: indecent
saying: cryptic
scandalized: somewhat
scantiness: comparative
scene: nocturnal
scheme: nefarious
scintillations: emerald
sciolism: stale
scions: promising
scorn: exoteric, immeasurable, intemperate, lashing, utmost, withering
scowl: revengeful
scruples: religious
scrutiny: unembarrassed
sea: complaining, opalescent, shoreless, silvery, unmurmuring
sealed: hermetically
seclusion: dismal
secreted: expeditiously
secretion: excretory
self-activity: conscious
self-irony: deprecating
selfishness: aggressive, corporate, fortified, sordid
sense: benighted, frightened, olfactory, overweening, proprietary, repentant, robust, sterling, tremulous
sensibilities: fine, tearful
sensibility: jaded, quick, vigilant
sensitiveness: singular
sensualist: senile
sentences: involuted
sentiment: egoistic, modified, threadbare, unimpeachable, vindictive
sentimentalism: maudlin, paralyzing
sepulcher: whited
sequence: graduated
serenity: impassable, saintly, unconscious
series: connected
seriousness: mock
service: proffered, qualifying
servility: groveling, prostrate
servitude: early, fattening
sex: waxwork
shadow: minatory, twilight
shadows: dappled, lengthening, purplish
sheen: iridescent
shield: blazoned
shimmer: phosphorescent
shortcomings: national
show: phantom, vainglorious
shrieks: eviscerating
shrillness: husky
shrug: deprecatory
significance: apparent, dictionary, horrid, permanent
signification: novel, wide
signs: indubitable
silence: banished, echoless, enforced, enigmatical, forbearing, moody, primeval, thoughtful, undisturbed
silent: immovably, meditatively
simplicity: infantile, rustic, sonorous
sinister: faintly
situation: proverbial
skepticism: cautious, pessimistic, undiluted
skies: autumnal
skill: diplomatic, specialized, superior, unequaled
sky: azure, crystalline
slave: affrighted
sledge-blows: hammer
sleepily: twittered
sluggishness: natural
smile: approving, cringing, icy, leering, mantling, petrified, uncomprehending
smoothness: glassy
sneer: vitriolic
sob: smothered
softness: angelic, displeasing
solemnity: invulnerable, pertinacious
solicitude: amiable, courteous, enlightened, maternal, nervous, overwhelming, tender
solitudes: romantic, still
something: intangible
sophist: fluent
sophistries: devilish
sophistry: shallow, subtle
sorrow: crushing, irremediable
soul: freeborn, shivering, sleepless, windowless
sound: attenuated
sounds: discordant
source: trustworthy
space: yawning
speaking: seditious
spectacle: inspiriting, ravishing, repulsive
specter: gaunt
speculation: rapacious
speculations: delectable
speech: captivating, interpolated, quibbling
speed: unresting
sphinx: sculptured
spicery: oriental
spinster: predestined
spirit: chivalrous, gleeful, innovating, interior, irradiating, pioneering, resilient, unrelenting, vagabondish
splendor: airy, alien, earthly, gorgeous, isolated, meridian, noonday, sparkling, unclouded
splendors: meteoric
sprightliness: girlish
spring: odorous
staggerings: discursive
stagnation: joyous
stare: stony
stars: winking
state: comatose, somnolent
statecraft: barbarous
statement: abridged, cogent, discredited, hackneyed, stringent
stature: diminutive
stealth: tigerish
steps: leaden
sterility: starched
sternness: sectarian
stillness: forest, hallowed, numbed
stimulant: powerful
stimulus: effectual
stolidity: crass
strain: selfsame
stranger: adulated
strategist: able
stream: slumbering
strength: burly, insular, massive, misspent
stride: stately
stroke: impressionistic
structure: deathless, monumental
struggles: militant
stupefaction: slow
stupidity: placid, vacant
style: demagogic, efflorescent, overbearing, unadorned
suavity: artificial
subject: entangled
subjects: allied
sublimity: terrible
submission: abject, dishonorable, sullen, unqualified
substance: solidifying
substratum: common
subtle: deviously
success: dubious, prospective
suddenness: volcanic
suggested: aptly
suggestion: alliterative, experimental, irrelevant
summons: obstreperous
sunlessness: subterranean
sunshine: dancing
superfluity: trifling
superiority: decided, enviable, mistrustful
superstition: credulous, dark, illiberal
supply: bountiful
supremacy: ascending, unapproached, unchallenged
surface: lustrous
surliness: superficial
surprise: dumb, pretended, speechless, staggering
surrender: virtual
survey: analytical
susceptibility: lively
suspicion: lurking, shrewd
suspicions: calumnious
sweep: cycloramic
sweetness: cloying, trailing, unembittered, unexampled
swiftness: grim, horrible, incredible
swing: determinate
symbol: significant
symmetrically: fashioned
sympathies: kindred, outstretching
sympathy: occult, overflowing, ready
symptoms: premonitory
taciturnity: sardonic
tact: exquisite
taints: polluting
tale: pointless
talent: squandered
talents: abnormal
talk: bandying, clumsy, sprightly, unceremonious
talker: paradoxical
tameness: insipid
task: irksome, thankless, uncongenial
taskmaster: exacting
taste: epicurean, fastidious, faultless, inbred, squeamish, vitiated
tedious: intolerably
temerity: dangerous
temper: accommodating, bristling, churlish, intractable, refractory, tart, ungracious
temperament: choleric, excitable, lethargic, mercurial, phlegmatic, ungenial, variable
tendencies: contrary, degrading, pervading
tendency: corrupting, cumulative, debasing, disintegrating, insidious, wolfish
tenderness: filial, lingering, paternal, sacred, unquenchable, yearning
tension: growing, slackened
tenure: brief, uncertain
termination: automatic, disastrous
terms: denunciatory
terrors: hypochondriacal
testimony: concurrent
thanks: grudging
thanksgiving: devout
theories: contradictory
thinking: coherent
thought: fructifying, galling, rebellious, tormenting
thoughts: errant, fugitive, gnawing, mutinous
thousands: unnumbered
thraldom: abhorred
thread: interwoven
threats: intermittent
threshold: unhallowed
thrill: disquieting
throb: responsive
throng: expectant
times: turbulent
timidity: acquired, maidenly, unmanly
tinge: rubicund
tints: roseate, transfiguring
tip-curiosity: toe
title: indefeasible
tittering: hectic
toil: unaccustomed, unremitting
tolerance: genial, queer, reluctant
tone: clarion, combative, dulcet, surly, unspiritual
tongue: faltering, mendacious, vampire
touch: apprentice, illusive, transmuting, whimsical
towers: castellated
track: unbeaten
tracklessness: spacious
tradition: revolutionary
traditions: storied
tragedy: unforgivable
trait: unsettled
tranquillity: drowsy
transition: abrupt, swift
transitions: rapid
trappings: warlike
treatment: declamatory, lucid
trees: clustering
tribunal: august, deaf
tribute: oblique, ungrudging
trick: ingenious
trickeries: mean
trifle: inconsiderable
trifling: arrant
triumph: dazzling, serene, unholy, veritable
troubadour: enamored
troublesome: unduly
truce: insecure
truculence: opinionated
trumpet: braying
truth: axiomatic, corroborated, multiform, unflattering, unpalatable
truths: embellished
tune: syncopated
twaddle: sentimental
twilight: limpid
type: idealistic, traditional
types: contrasted
tyranny: fettered, odious
uncertainty: nebulous
undulations: successive
uprightness: thorough
urbanity: humorous
utterance: impromptu, lisping, oracular
vacillation: desultory
vagueness: atmospheric, delicious
valor: individual
value: indeterminable
vanished: straightway
vanity: adorable, distorted, insatiable
vanquished: bravely
variation: corresponding, delightful, unceasing
variety: embarrassing, humorless, prodigious
vehemence: headlong, ungovernable
vehement: outrageously
vein: allegorical
vengeance: hoarded, summary
venture: nautical
verbiage: conventional, sounding
verbosity: diffuse
verdict: irrevocable
vibration: clamorous
vices: despicable, repelling
vicissitudes: unforeseen
victory: inglorious
view: atrophied, compressed, contracted, mercenary, preconceived
views: antagonistic
vigilance: ceaseless
vigilant: proportionately
vigor: concentrated, pedestrian, superhuman, sustained
villainy: execrable
vindication: spirited
vindictiveness: selfish
violation: casual
violence: eruptive, explosive, sacrilegious, unprincipled
virtue: cloistered, unsullied, vicarious
virtues: homebred, shining
virulence: deadly
visage: deformed, expressionless, patriarchal
vision: apocalyptic, beatific, blurred, prophetic
visit: abbreviated, projected
visitings: compunctious
vitality: deficient, healthful
vivacity: extraordinary
vociferation: loud
voice: beguiling, derisive, influential, quavering, stentorian
volubility: unslackened
volume: incessant, onflaming
voracity: famished
wail: sobbing
wanderer: penniless
wandering: vagrant
warfare: acrimonious, wordy
warmth: emotional, imaginative, penetrating
warning: muttered
warrior: grizzled
waters: engulfing
way: adventitious
wayfarer: trudging
waywardness: willful
wealth: centralized
weariness: woeful
well-period: turned
west: blackening
whim: thoughtless
whisperings: seductive
whiteness: snowy
whole: homogeneous
wickedness: rampant, resourceful
wife: termagant
will: irresistible
wind: homeless, hooligan
windings: labyrinthian
windows: mullioned
winds: wailing, whistling
winter: unremembered
wisdom: collective, ethical, precocious, prudential, sententious
wisp: shrunken
wistfulness: strange
wit: adaptive, aphoristic, contagious, flashing, mordant, playful, scintillating
witchery: moonlight
witticism: battered
womanhood: stainless
wonder: frozen
woodland: untrodden
word: plighted
wordiness: wearisome
words: sesquipedalian
world: droning, ultrafashionable
wrath: threatened
wreath: votive
wretch: bedraggled
writers: predatory
yearning: impatient, indefinite, unsatisfied
yearnings: involuntary
years: dissolving, hurrying
yielding: injudicious
youth: adolescent, amorous, disillusioned, unsophisticated
zeal: burning, composed, consuming, emulative, excessive, flaming, guileless, impetuous, laudable, persecuting, philanthropic, unflinching
zealot: unenlightened
zealous: actively
zest: unflagging
